8 9 10 10 10 10 10 10 10 10 10 10 10 10 10 16 15
6 7 1 1 1 1 1 0 1 1 1 1 1 1 1 14 13
6 7 2 0 2 0 2 0 2 0 2 0 2 0 2 14 13
6 7 2 2 2 2 2 2 2 2 2 2 2 2 2 14 13
6 7 2 0 2 0 2 0 2 0 2 0 2 0 2 14 13
6 7 2 2 2 2 2 2 2 2 2 2 2 0 2 14 13
6 7 2 0 2 0 2 0 2 0 0 0 2 0 2 14 13
6 7 2 2 2 2 2 2 2 0 2 18 2 2 2 14 13
6 7 2 0 2 0 2 0 2 0 2 0 2 0 2 14 13
6 7 2 2 2 2 2 2 2 2 2 2 2 2 0 14 13
6 7 2 0 2 0 2 0 2 0 2 0 2 0 2 14 13
6 7 2 2 2 0 2 0 2 0 2 2 2 2 2 14 13
3 4 5 5 5 5 5 5 5 5 5 5 5 5 5 12 11