2 3 4 4 4 4 4 4 4 4 4 4 4 4 4 5 6
14 18 0 0 0 0 0 0 1 0 0 0 0 0 0 19 7
14 15 0 1 0 1 0 1 0 1 0 1 0 1 0 8 7
14 15 0 0 0 0 0 0 0 0 0 0 0 0 0 8 7
14 15 0 1 0 1 0 1 0 1 0 1 0 1 0 8 7
14 15 0 0 0 0 0 0 0 0 0 0 0 0 0 8 7
14 15 0 1 0 1 0 1 0 1 0 1 0 1 0 8 7
14 15 0 0 0 0 0 1 0 0 0 0 0 0 0 8 7
14 15 0 1 0 1 0 1 0 1 0 1 0 1 0 8 7
14 15 0 1 0 0 0 0 1 0 0 0 0 0 0 8 7
14 15 0 1 0 1 0 1 0 1 0 1 1 1 0 8 7
2 16 0 1 0 0 0 0 0 0 0 0 0 0 0 17 6
13 12 11 11 11 11 11 11 11 11 11 11 11 11 11 10 9